  ar: {
    common: {
      tagline: "وجهتك الأولى للمواهب الرياضية",
      soccerHunter: "صقر هانتر",
      worldClassPlatform: "منصة عالمية المستوى",
      home: "الرئيسية",
      login: "تسجيل الدخول",
      logout: "تسجيل الخروج",
      myAccount: "حسابي",
      players: "اللاعبين",
      coaches: "المدربين",
      technicalDirector: "المدير الفني",
      supportStaff: "الجهاز المعاون",
      goalkeepers: "حراس المرمى",
      fitnessCoaches: "مدربي اللياقة",
      goalkeepingCoaches: "مدربي الحراس",
      clubs: "الأندية",
      agents: "الوكلاء",
      doctors: "الأطباء",
      news: "الأخبار",
      about: "حول الموقع",
      contact: "اتصل بنا",
      services: "الخدمات",
      categories: "الفئات",
      searchPlayers: "البحث عن لاعبين",
      searchCoaches: "البحث عن مدربين",
      openMenu: "فتح القائمة",
      assistant: "المساعد",
      analyst: "المحلل",
      physiotherapist: "أخصائي العلاج الطبيعي",
      nutritionist: "أخصائي التغذية",
      teamManager: "مدير الفريق",
      kitManager: "مسؤول الملابس",
      scoutingTeam: "فريق الكشافة",
      language: "اللغة",
      changeLanguage: "تغيير اللغة",

      // Player positions
      striker: "مهاجم",
      strikers: "المهاجمين",
      attackingMid: "وسط مهاجم",
      defensiveMid: "وسط مدافع",
      defensiveMidfielders: "لاعبي الوسط الدفاعي",
      leftWing: "جناح أيسر",
      rightWing: "جناح أيمن",
      leftBack: "ظهير أيسر",
      rightBack: "ظهير أيمن",
      centerBack: "مدافع وسط",
      goalkeeper: "حارس مرمى",
      allPlayers: "جميع اللاعبين",
      forwards: "مهاجمين",
      midfielders: "لاعبي وسط",
      defenders: "مدافعين",
      wingbacks: "ظهيري جنب",
      
      // Home Page - Position Descriptions
      goalkeeperDescription: "خط الدفاع الأول وحامي المرمى",
      strikerDescription: "هدافين ومهاجمين محترفين",
      leftWingDescription: "لاعبي الجناح الأيسر السريعين",
      rightWingDescription: "لاعبي الجناح الأيمن المبدعين",
      attackingMidDescription: "صناع الأهداف ولاعبي الوسط المهاجم",
      defensiveMidfielderDescription: "محاربي الوسط والمدافعين",

      // Coach types
      headCoach: "مدرب رئيسي",
      assistantCoach: "مدرب مساعد",
      allCoaches: "جميع المدربين",

      // Dashboard types
      adminDashboard: "لوحة تحكم المدير",
      userDashboard: "لوحة تحكم المستخدم",
      playerDashboard: "لوحة تحكم اللاعب",
      coachDashboard: "لوحة تحكم المدرب",
      clubDashboard: "لوحة تحكم النادي",
      agentDashboard: "لوحة تحكم الوكيل",
      doctorDashboard: "لوحة تحكم الطبيب",

      // Home Page - Service Descriptions
      coachesDescription: "مدربين محترفين ومؤهلين",
      doctorsDescription: "أطباء متخصصين في الطب الرياضي",
      clubsDescription: "أندية محترفة وأكاديميات",
      agentsDescription: "وكلاء لاعبين معتمدين",

      // Home Page - Specialties
      sportsMedicine: "الطب الرياضي",
      physiotherapy: "العلاج الطبيعي",
      sportsNutrition: "التغذية الرياضية",
      sportsPsychology: "علم النفس الرياضي",
      professionalClubs: "الأندية المحترفة",
      academies: "الأكاديميات",
      youthDevelopment: "تطوير الشباب",
      scouting: "الاستطلاع",
      talentManagement: "إدارة المواهب",
      contractNegotiation: "التفاوض على العقود",
      careerDevelopment: "تطوير المسيرة المهنية",
      transfers: "الانتقالات",

      // Home Page - Other
      searchPlaceholder: "ابحث عن لاعبين، مدربين، أندية...",
      featuredPlayerCategories: "فئات اللاعبين المميزة",
      explorePlayerPositions: "استكشف مراكز اللاعبين المختلفة واعثر على المواهب المناسبة",
      professionalServices: "الخدمات المهنية",
      comprehensiveSportsEcosystem: "نظام بيئي رياضي شامل يلبي جميع احتياجاتك",
      exploreService: "استكشف الخدمة",
      exploreCategory: "استكشف الفئة",
      quickActions: "الإجراءات السريعة",
      getStartedToday: "ابدأ رحلتك الرياضية اليوم",
      createProfile: "إنشاء ملف شخصي",
      createProfileDescription: "أنشئ ملفك الشخصي واعرض مواهبك للعالم",
      findTalent: "اعثر على المواهب",
      findTalentDescription: "ابحث عن أفضل المواهب الرياضية في منطقتك",
      startSearching: "ابدأ البحث",
      getSupport: "احصل على الدعم",
      getSupportDescription: "تواصل مع فريق الدعم للحصول على المساعدة",
      joinSoccerHunter: "انضم إلى صقر هانتر",
      joinDescription: "انضم إلى آلاف المواهب الرياضية واكتشف فرصاً لا محدودة",
      joinNow: "انضم الآن",
      learnMore: "اعرف المزيد",
      getStarted: "ابدأ الآن",
      contactUs: "اتصل بنا",
      
      // Statistics
      activeUsers: "المستخدمين النشطين",
      successfulMatches: "المطابقات الناجحة",
      countries: "الدول",
      userRating: "تقييم المستخدمين",
      featured: "مميز",
      specializations: "التخصصات",
      
      // Common Dashboard Terms
      loading: "جاري التحميل...",
      saving: "جاري الحفظ...",
      success: "نجح",
      failed: "فشل",
      active: "نشط",
      view: "عرض",
      edit: "تعديل",
      save: "حفظ",
      cancel: "إلغاء",
      delete: "حذف",
      search: "بحث",
      filter: "تصفية",
      all: "الكل",
      status: "الحالة",
      actions: "الإجراءات",
      
      // View options
      gridView: "عرض شبكي",
      listView: "عرض قائمة"
    }
  },
